█████████████████████████████████████████████████████████████████████████████████
█X     █   █   █ █ █         █   █     █   █ █     █         █ █   █     █     ██
█ █████ ███ ███ █ █ ███████ █ █ ███ ███ ███ █████ ███ █ ███ █ █ █ ███ ███ █ █ █ █
█ █   █ █ █   █   █   █     █ █       █     █         █ █   █   █ █   █ █ █ █   █
█ ███ █ █ ███ ███ █████ █ █ █ █ █ █ █ ███ █ █████ █ ███ ███████ █ ███ █ ███ █████
█         █   █ █   █   █ █ █ █ █ █ █   █ █   █   █ █     █ █ █ █       █       █
█ █ █████ █ █ █ █ ███ ███ ███ █████████ █████ ███ ███████ █ █ █ ███ ███ ███ █████
█ █   █   █ █   █ █ █ █ █       █   █ █           █   █     █     █   █   █     █
█████ █████ ███ █ █ ███ █ █████████ █ █████ ███ ███ ███ ███ █ █ ███████ █ █ █████
█     █     █   █       █   █ █     █         █       █ █     █ █       █ █ █   █
███ █ █ ███ █████████ █ █████ █ ███ ███ ███████ █ ███ ███ █ ███████████ ███ █ ███
█ █ █   █ █   █   █ █ █   █     █   █       █   █ █ █ █   █     █     █ █       █
█ █ █████ █ █████ █ ███ █ █ █ █████ ███ █ █ █ █████ █ █ ███ ███████ █ █ █████ ███
█   █ █ █               █ █ █ █         █ █ █ █ █     █   █ █   █   █ █   █ █ █ █
█ █ █ █ █ ███ █ ███ ███ █ █████████ █████ █████ █ █ █████████ █ ███ █ █ ███ █ █ █
█ █ █       █ █ █ █ █   █ █         █           █ █   █ █     █     █           █
███ █████ ███████ ███ ███████████████ █████████ ███ ███ █████ █ ███ ███████ ███ █
█ █   █   █   █ █             █ █   █ █           █ █   █   █ █ █   █ █   █ █ █ █
█ ███ ███ █ ███ █ █ ███ █████ █ ███ ███ ███ █ ███████ ███ ███ ███ ███ █ ███ █ █ █
█       █ █       █ █       █ █           █ █       █ █     █ █   █           █ █
█████ █████ ███ ███████ █ ███████████ █████ ███████ █ ███ █████████████ ███████ █
█     █ █   █         █ █ █   █ █         █   █ █     █       █ █   █   █   █   █
█████ █ ███ ███ ███ █ ███ █ █ █ █ ███████████ █ ███ █ █ █ █ █ █ █ ███████ ███ █ █
█   █   █ █ █ █ █   █   █   █         █   █   █     █   █ █ █ █ █   █ █     █ █ █
█ █████ █ ███ ███ █ █ ███ █████ ███████ ███████ █████████ █████ ███ █ █ ███████ █
█       █   █     █ █ █   █   █       █     █ █ █     █   █ █         █ █ █   █ █
█ █████████ █████████████ ███ █ █████████ █ █ █████ █ █ ███ ███ █ █████ █ █ █████
█     █   █       █   █ █     █   █       █   █   █ █ █     █ █ █         █ █   █
█ █ █ █ █████ ███ ███ █ █ ███████ ███████ ███████ ███ ███ ███ ███ █ █ █ ███ █ ███
█ █ █       █   █   █   █   █       █ █     █     █     █ █       █ █ █ █ █     █
█ ███████ █ ███ █████ █████ ███ ███ █ ███ ███ ███ █████ █ █ █████ █ █ █ █ █ ███ █
█   █ █   █   █ █     █   █ █   █             █ █   █ █       █ █ █ █ █       █ █
█████ ███ █████ ███ █████ █ ███ ███ ███ █████ █ █ █ █ █ █████ █ █ █ ███████████ █
█   █       █   █ █   █   █ █   █   █   █ █ █   █ █ █   █ █   █   █   █   █     █
█ ███ █ ███ ███ █ █ ███ ███████ █████ █ █ █ █████ █ █████ █ █████████████ █ █████
█ █   █ █         █         █       █ █   █       █ █     █   █ █   █     █ █   █
█ ███ █████████ █ █████ ███ ███████ ███████ █ █ ███████ █ ███ █ █ █████ █ █████ █
█   █ █   █     █       █   █         █   █ █ █   █     █   █           █     █ █
█ ███ █ █████████ ███ ███████ █ ███ █████ █████ █████ █ █████ █████ ███ ███████ █
█         █       █         █ █   █ █           █     █           █   █         █
█████████████████████████████████████████████████████████████████████████████████ 