┌┬────────────────────────────────┬──────────────────────┬───┐
├┘                                │                      │   │
│   ┌───┬──────────┬────────────    ─────────────────┐   │   │
│   │   └──────────┘                                 │   │   │
├── │                   ┌─────┬──────────┬─┬────┬──┐ │   │   │
│   │  │   ┌────────────┤     └──┼┼──────┘ │    ├──┤ │   │   │
│   │  │   │            ├───┬─   └┘             │  │ │   └──┬┤
│ ──┤  │   └─────────   │   │       ┌─────┬──┐     │ └─┐    ││
│   │ ┌┤              ┌─┼┐       ┌─┬┘     ├──┴┬──┐ │   │    ││
│   │ └┴─────┬──────┐ ├──┴────┬─ ├─┤    ──┘   │  │ └┐  │    └┤
├── │        ├──────┘ │       │X │ └──┬┐   ─┐    │  │  ├──   │
│   ├─┬─┐    │        │ ┌───  └──┤    └┤    │  ┌─┘  │  │     │
│   ├─┤ └┐           ┌┤ │        ├──   │    │  │    │  │     │
│   │ │  └──┬───┬────┴┤   ┌──  ─┬┘    ┌┤   ─┴──┤    │  │     │
│   │       ├───┘     └─  │     │  ┌──┼│       │    │  │ ────┤
│   │   ────┤             │  ──┬┘  │  ├┴───    │  │ │  │     │
│ ──┤       │ ─┬┐ │  ┌────┤    │   │  │        ├──┘ │  │     │
│   ├───┐   │  ├┴─┤  ├────┴──┐ └─  │    ────┐  │    │  │     │
│   │   │      │  └──┘       │     │        │  │    │  ├──── │
├── │        ──┘      ┌──────┤   ──┴───┐  ┌─┴──┼──  │  │     │
│   ├┐          ┌─────┘      │         │  │    │    │  │     │
│   ││    │     │      ┌┬────┴─  ┌─┬─┐ │     ──┴┐  ─┤  │     │
│   ├┘    │     │   ───┴┤        │┼│ │ └──┐     │   │  │ ────┤
│   │     │     │       │  ──────┴┼┘ └─   │     │   │  │     │
│  ─┼──┐ ─┴─────┴─┐     └┐        │      ┌┤ │   │   │  │     │
│   │  │          │   │  └┬┬────  │  ─┐  └┴─┴┬─     │  ├──── │
├┐  └──┴──   ─┐  ─┴───┴─  └┤     ─┘   │      │   │  │  │     │
├┴┐           │            ├──┐       │   │      ├──┤  │     │
│ │  ─────┐   └────────────┴──┴───────┴───┴──────┴──┘        │
│ │       │                                               ┌──┤
└─┴───────┴───────────────────────────────────────────────┴──┘