█████████████████████████████████████████████████████████████████████████████████████████████████████
█           █       █ █ █ █   █ █ █         █     █   █     █       █     █     █ █ █ █             █
█ █ █ █████ █ ███ █ █ █ █ █ █ █ █ █ ███ █ ███████ █ █ █ █ █ ███ █ ███ █ ███ ███ █ █ █ █ ███ ███ █████
█ █ █   █     █   █         █ █     █ █ █ █     █ █ █   █ █ █   █ █   █   █ █ █   █     █     █   █ █
█ █ ███ █████████ █ █ █ █████████ ███ █ ███ ███ █ ███████ ███████ █ █ ███ █ █ █ █ █ █ █████ █ █ █ █ █
█ █ █   █ █ █     █ █ █ █         █ █ █   █   █ █   █         █     █ █       █ █   █ █     █ █ █   █
█ ███████ █ █ █████ ███ █ █ █ ███ █ █ ███████ ███ █████████ █ ███ █████ ███████ ███ █ ███████ █ █ ███
█     █ █   █ █   █ █   █ █ █   █   █ █ █   █   █       █   █ █   █ █       █   █   █     █   █ █   █
█ █████ ███ █ █ █████████████ ███████ █ █ ███ █ █████ █████ ███ █ █ █ ███████ █████ █████ █ █ ███ ███
█ █       █     █   █     █         █         █   █ █         █ █   █     █ █   █   █   █ █ █ █ █ █ █
███ ███ █████ █ █ █████ █████ ███ █ █ █ ███ ███████ ███ ███ █████ █ ███ █ █ ███ ███ ███ ███████ █ █ █
█   █   █     █       █ █ █     █ █   █ █ █ █     █ █   █ █ █     █   █ █ █ █     █   █ █ █   █   █ █
███████ █ █████████ █ █ █ ███████ █ ███ █ ███████ █ ███ █ █ █ ███████ █ ███ █ █████████ █ ███ █ █ █ █
█           █       █             █ █ █   █ █       █     █ █   █   █ █ █   █ █ █               █ █ █
█ █ █ █████ █████ ███ █████ █ █████ █ █ ███ ███ █ █ ███ █████ ███ ███████ █ ███ █ ███ █ █████████ █ █
█ █ █   █   █     █ █ █   █ █ █       █       █ █ █           █ █ █ █ █   █       █   █         █   █
█ █ █ █████ ███ ███ █████ █ █████ █ ███████ █████ █ ███████ █ █ █ █ █ █ ███ █ █████ ███████ █████████
█ █ █ █ █   █     █ █ █       █   █       █ █     █   █     █     █   █   █ █ █   █       █   █ █ █ █
█ █████ ███ ███ █ █ █ ███ █████████ ███████ ███ █████ ███ █████████ ███ ███ █████ ███ █ ███████ █ █ █
█     █     █   █   █   █ █   █ █         █   █ █ █   █       █         █ █     █ █   █ █   █ █ █   █
█ ███████ █ ███ ███ █ █████ ███ █ █████ █████████ █████ ███████ █ ███ ███ █████ █ █ ███████ █ █ █ █ █
█       █ █ █ █ █ █ █     █ █       █       █ █     █     █ █ █ █   █     █   █   █   █   █   █   █ █
█ █████████ █ ███ █ █████ █ █ █ █ █████████ █ █ █████ █████ █ ███ ███████████ ███ ███ █ █ █ ███████ █
█   █ █   █ █     █ █ █       █ █ █       █     █         █ █ █ █   █ █     █ █ █   █ █ █     █     █
█ ███ █ ███ █████ ███ ███████ █ █████████ █ ███ █ █████████ █ █ █ █ █ ███ █ █ █ █ ███████ █ █████ ███
█       █     █   █   █ █   █ █     █       █   █     █ █         █   █   █ █             █         █
█ █ ███████ █ ███ █ █ █ ███ ███████ █ █ █ ███████ ███ █ ███ ███ █████ █ ███████ █ ███ █ █ ███████ █ █
█ █ █   █   █   █   █ █     █     █ █ █ █     █   █   █   █   █     █ █   █   █ █   █ █ █ █   █ █ █ █
█ ███ █ █ ███ ███ █ ███ █ ███████ ███ ███ █ █████ ███████ █ █ ███████ █ ███ █ ███████ ███████ █ █ ███
█   █ █ █ █     █ █ █   █       █     █   █ █   █         █ █ █   █ █ █   █ █             █ █       █
█ ███ █████ ███ █ ███ ███████████████ █ ███ ███ █ █ █████████████ █ █ █ ███████████████████ ███ █████
█       █     █   █       █       █   █   █ █   █ █       █ █ █ █   █     █ █       █       █   █   █
█ █████████ █ █████ ███ ███ █ ███ █████████ █ ███ ███ █ █ █ █ █ █ █████ █ █ █ █████ █████ █ █ █ █ ███
█     █ █ █ █     █ █       █ █ █ █   █   █ █       █ █ █   █     █ █ █ █ █   █       █ █ █ █ █     █
█ █ ███ █ █ █████ ███████ █████ ███ ███ █████████████████████████ █ █ ███ █ █ █ ███ █ █ ███ █ ███ █ █
█ █     █       █           █ █       █   █   █ █ █ █ █   █ █ █ █           █ █   █ █     █     █ █ █
█ █ ███████ ███ █ █████████ █ ███████ █ ███ ███ █ █ █ ███ █ █ █ ███ █ ███████ █████████ █ █████ █████
█ █     █     █ █ █ █ █     █   █       █   █ █ █ █           █     █ █ █   █ █     █   █ █ █       █
█ █ █ ███ █ ███████ █ ███ █ █ ███ ███ █ █ ███ █ █ █ ███ ███ ███ █ █ ███ ███ ███ █ █ ███████ ███ █ █ █
█ █ █ █ █ █     █     █ █ █       █ █ █         █   █ █ █ █ █   █ █ █ █       █ █ █   █ █ █ █ █ █ █ █
█ █████ █ ███████ ███ █ █████ █████ ███ ███████ ███ █ █ █ ███ ███████ █ █████ ███████ █ █ █ █ █ ███ █
█   █   █   █   █   █ █ █ █     █ █ █       █ █     █     █   █     █   █     █         █ █     █ █ █
█ █████ █ █ █ ███████ █ █ █ ███ █ █ ███████ █ ███ ███ ███ █ █ ███ ███████ █████ █████ █ █ ███ ███ █ █
█       █ █   █               █ █               █ █     █   █               █     █   █       █   X █ 
█████████████████████████████████████████████████████████████████████████████████████████████████████ 