┌───────────────────────────────────────────────────────────────────────────────┐
│                                                                               │
│  │ ┌───────────────────────────────────────────────────────────────────────   │
│  │ │                                                                          │
│  │ │              ─────────┐    ──┐       ───┐       │   ┌────────────     │  │
│  │ │     │                 │      │          ├───────┤   │              │  │  │
│  │ │     │    ─────────────┴──────┴──────────┴───┼───┴───┴───────────┬──┤  │  │
│  │ │ ┌───┤                                       │                   └──┤  │  │
│  │ │ │   └──┬─────┬────┐           │   ─────┬────┤        ┌──────┬───   │  │  │
│  │ │ │ │    │     └────┴──────     │        └────┴──────  │      │      │  │  │
│  │ │ │ │                           │                             └────  │  │  │
│  │ │   │ ┌─┬──  ┌───────┬──────────┴─────────────────────────           │  │  │
│  │ │   │ ├─┤    │       │                                      ───────┐ │  │  │
│  │ │   └─┤ │    │       │      ┌────────────┬┐                        │ │  │  │
│  │ │ │   │      │       │      │            ││  ──┬──────────────┬────┴─┤  │  │
│  │ │ └─┬─┴──────┤    ───┘      │  ─────┬──┐ ││    │              │      │  │  │
│  │ │   │        │              │       │ X│ ││    │              │      │  │  │
│  │ │     ┌─┐    │              │     │   ┌┤ └┤    │    ──────────┘      │  │  │
│  │ │     │ │    ├────────────  └─────┤  ┌┴┘  │    │                     │  │  │
│  │ │  ───┘ │    │                    │  │   ┌┤    ├─┬───┬────────┬────┐ │  │  │
│  │ │       │    │     │            ┌─┤  │   └┤    │ └───┘        │    │ │  │  │
│  │ │       │    │  ───┤     ┌──────┘ └──┴──  │    │      ┌─┬──┐   ─┐  │ │  │  │
│  │ │   ────┴────┤     ├─┐   │                │    │ ─┬──┬┼┼│  ├─┐  │  │ │  │  │
│  │ │            ├─────┘ │       ┌────────────┘    │  │  └──┼──┴┼│  │  │ │  │  │
│  │ │            │       │       │                 │        │   └┴──┘  │ │  │  │
│  │ │     ───┐   │       │    ─┬─┤  ┌──────────────┘ ┌──────┘          │ │  │  │
│  │ │        │   │          │  │┼┼──┤                │       ┌──────┐    │  │  │
│  └─┤        │   │          ├──┴────┴────────────────┴───────┴──────┘    │  │  │
│    │    │   ├┬──┴────────  │                                            │  │  │
├──┐ │    └───┼│             │                                        │   │  │  │
│  │ │        ├┘  ───────────┴──────────┐         ────┬────────┐   ───┼─┐ │  │  │
│  │ │        │                         │             │        │      │ │ │  │  │
│  │ │    ┌───┴────────┬─────────────          ───────┘        ├──────┘ │ │  │  │
│  │ │    │            │                                       │          │  │  │
│  │ │          ───────┘      ─────────────────────────────────┴──────────┘  │  │
│  │                                                                         │  │
│  │  ───────────────────────────────────────────────────────────────────────┴─ │
│                                                                               │
└───────────────────────────────────────────────────────────────────────────────┘