┌──────────────────────┬─┬──────┬─────────┬──────────┬─────────┬───────┬───────┬───────────┐
│X                     ├─┤      │         │          └─────────┘       │┼┼────┼│           │
├┬─ ┌─────────────────┬┘ ├───┐      ┌──┐    ┌──┬──┬─              ┌┬───┼┼│    └┘ ┌───┬───┐ │
││  └─────────────────┘ ─┴───┴─  ───┴──┘    │  └──┘     ┌──────┐ ─┼│   └─┤       │   └─┼─┘ │
│┼┐                                      ┌──┘           │┼┼┼───┘  ├┘  │  └─┐ ┌───┴──   │   │
│┼┼───┐ ┌┬───┬───────────────────────────┤      ┌┐   ┌┬─┴─┼│    ┌─┘  ┌┼┐   ├─┤             │
├─────┴┬┴┘   └───────┼┼┼┼┼┼┼─────────────┘  ┌┐  │┼─┬┬┴┘   │┼────┤   ─┼┼┼┐ ┌┼─┘      ┌┐  ──┬┤
│      │             └─────┘                └┘  ││ └┤     └───┼┼┴──  └─┼│ ││   ┌┬──┬┼│    ││
├──────┼────────────┐            ┌┬───┬────┐    ││  ├┐        ││   ┌┐  ├┘ │┼┐  └┘  └─┘    └┤
├───────────────────┴┬┬─ ┌───────┼│   │┼───┴─┬┐ ││  ││  ┌──┐  ││   │┼──┤  └─┴─    │        │
│                    ││  └───────┼│  ─┴┤     └┼─┼┼┐ ││  └──┤ ┌┼│ │ └──┼│       ──┬┼─┐   ┌──┤
├───┐ ─────┬─────┬─ ┌┴┤          │┼─┐  └┬┐    │ └─┘ └┘     ├─┼┼│ │    └┘ ──┬──┐  └─┼│   └┼┼│
├───┘      └────┼│  │ ├────┐     │┼┼┼┐  ││  ┌─┼┐          ┌┘ │┼│   ┌─┐     └──┘    ││  │ │┼│
│     ┌──┐      └┴──┘ └──┼┼│     ├───┘  └┤  └──┘      ┌───┤  │┼│  ─┼┼│  ┌┐         ├┘  └─┴─┤
├─┐   ├─┼┘ ┌──           └─┤    ┌┤       ├┐      ┌─┐  └──┼│  └┼│   └┼│  └┤  │  ┌───┤       │
│┼┼─┐ │ │  │  ┌───────┐    ├─┐  │┼─────┐ ├┘ ┌┐   │ │     ││   └┘    └┘   └──┴──┴───┘   ┌┐  │
├───┤ │ └──┘  └───────┴─┐  └┼┘  └┼─────┘ │ ─┼┼─┐ └┬┼─┐   ├┴─┐    ┌┐                 ┌──┼│  │
│   ├┐                  ├─  │    │       │  ├──┘  ││ │   │  ├─  ─┼│   ┌──┐ ┌┐  ──┐  └──┼│  │
│   └┴─┬┐ ──────────────┘       ─┴─    ──┴──┘     └┴┬┘   └──┘    └┴─  └─┼┘ └┘    ├┐    └┘  │
├─┐    ││                                           │                   │     ┌──┼│        │
└─┴────┴┴───────────────────────────────────────────┴───────────────────┴─────┴───┴────────┘