┌────────────────┬─┐
│                └─┤
│    ┌─────────┐   │
│    │         │   │
│  ┌─┤         │ ┌─┤
│  └─┤         │ │ │
│    │         │ │ │
├──┐ │         │ └─┤
│  │ └─────────┘   │
├──┤           X ┌─┤
└──┴─────────────┴─┘