┌────────┬─────┬────────────────────────────────────────────────┬───────┬─────────────────────────────┐
│ X      └─────┤                                                └┼┼┼┼───┤                             │
│  ┌┐          ├──────────────────────────────────────────────┐  └──┘   └─┬─┬────┬─┐ ┌┐        ┌┐     │
│  ││      │   └─────────────┼┼┼┼┼┼┼┼┼┼┼┼┼┼┼┼┼┼┼──────────────┘           └─┘    ├─┴─┼┼───┐ ┌──┼┼┬─   │
├┬─┴┴──────┘                 │┼┼┼──────────────┤                    ┌───┐     ┌┬─┘   ├────┘ │  │┼┘    │
││            ┌──────────────┼┼┼│              │             ┌───┬──┤   ├──  ─┴┘     │      │  ├┘     │
││  ┌─────────┼┼┼┼┼┼┼┼┼┼┼┼┼┼┼┼┼┼┼──────────────┼─────────┐ ──┴───┘  └───┘            │   ┌─┬┘  │      │
││  └───────┼┼───────────────────────────────────────────┘                    ┌┐ ┌─┐ │   │┼│          │
││          ││                                                         ┌┬───┐ └┼─┤ │ │   │┼│  ┌┐  ┌┐  │
││   ┌┬───┬─┼┼─────────┐            ┌─────┬────────────────────────────┼│   │  │┼┴─┘     │┼┘  ││ ┌┼│  │
││   ├┘   └┼┼┼┼┼┼┼┼┼┼┼┼┼───────┐   ─┘     └────────────────────────────┼│   └──┴┘     ┌──┼│   ││ ├─┤  │
├┘   │     └─────────────┼──┼┼┼┴┐                                      │┼┐         ┌─┬┼┼─┼│   ││ │ │  │
│    │                   │  │┼│ │   ┌───┐                            ┌─┴─┴───┬──┐  │ │┼│ └┘   ││ ├─┘  │
│  ┌─┼─┐                 └──┴─┴─┘   │   │  ┌───┐     ┌┐             ┌┘       └──┘  │ └─┼┐    ─┼│ │    │
│  │┼┼┼┼┬────────┬──┐               │   ├──┼┼┼┼┼─────┼│     ┌┬──────┘  ┌──┐        │   ││     │┼─┼┐   │
│  └────┘        └──┴┬┐       ┌───┬─┤   ├────────────┼│     ││         │  ├────┐   └┬┐ │┼─┬─  │┼──┘   │
│                    └┴───────┴───┘ └───┘            └┘     └┼─┐  ─────┴──┘    ├─┐  └┴─┼┼─┤   └┘      │
│                                                            │┼│               └┼│     ││ │           │
│    ┌───────────────────────────────────────────────────────┼┼┼─────────────┐  │┼───┐ ││         ┌─  │
├┬───┴─────────┼───┼──────┼────┼─────┼───────┼──────────────────────────┼┼┼┼┼│  └────┤ ││    ┌┐  ─┤   │
├┘             │   │      │    │     │       │                          └──┼┼│       ├┬┴┴┐ ┌─┼│   │   │
│   ┌───┬┐                                                      ┌─┐        └─┴──     └┘  └─┘ │┼┐  │   │
│   │   │┼──────────────────────────────────────────────┐       │ │                          │┼┴──┤   │
│   │   └───────────────────────────────────────────────┘       │ │  ────────────┬───┬───────┴┘   └─  │
│   │                                                          ┌┼─┼┐             └───┘                │
│   └──────────────────────────────────────────────────────────┴───┴─────────           ┌────────┐    │
│                                                                              ┌─────┐  │┼┼┼┼┼┼┼┼│    │
└──────────────────────────────────────────────────────────────────────────────┴─────┴──┴────────┴────┘