┌───────────────────────────┐
│                           │
│                      ┌──┐ │
│   ┌───┐              └──┘ │
│   │   │     ┌────┐        │
│   └───┘     └────┘        │
│                           │
│   ┌──┐   X    ┌─┐         │
│   │  │        └─┘         │
│   └──┴┬────┐      ┌─────┐ │
│       │    │      │     │ │
│       │    │      │     │ │
│       └────┘      └─────┘ │
│                           │
│                           │
└───────────────────────────┘