┌────────┬────────────────────────┬──────────────┐
│        ├──┼┼┼┼┼┼┼┼┼─────────────┤              │
├────┬───┤  ├───────┤             ├─┬──┐  ┌─┬┐   │
│    │   ├──┘       └────────────┬┼─┤  └┬─┤ ││   │
│    │  ┌┘     ┌┐                └┘ │   ├─┴─┴┤   │
│   ┌┘ ┌┘   ┌─┬┴┼───────    ───┐   ─┴┐ ┌┤    │   │
│   │ ┌┘   ┌┼─┘ │        ┌┐    ├┐    │ └┴┬┬─┬┴┐  │
│   │ │   ┌┴┘     ┌──────┼┼┬─┬─┼│ │  │   ││ │ │  │
├───┘ │   │       │┼┼┼┼┼┼┼┼│ │ ├┘ │  ├─ ─┴┼┬┘ │  │
│     │   │  ┌─┬──┴──┼┼┼┼┼┼┴┬┼┬┘  ├──┤    └┤  │  │
├─────┘   │  │┼┘     ├────┤ └─┤  ─┤  │ ┌─┐ │  └──┤
│       ┌─┘ ┌┼│  ┌─┬─┘  X │   └─  ├──  │ │ ├┐    │
│      ─┤   ├─┘  │┼│    ┌─┘       │    │ │ ├┘ ┌──┤
│       │  ─┘   ┌┼─┘   ┌┘    │ ┌──┼─   ├┬┴─┘  │┼┼│
├───┐   └┐    ┌─┴┘   ┌┬┘    ┌┴┬┴─┼┘  ┌─┴┤    ┌┼┼┼│
│   │    │  ──┤     ─┴┤     │ │  │   │  └─  ┌┴┼──┤
│   └┐   └┐   └─┐     │  ┌──┼─┼─    ┌┴┐     │ │  │
│    └┐   │     └─┐   └─ │  └─┤ │   │ └┬┐    ┌┤  │
│     └┐  └───┐   └┬┐    └─   ├─┘  ─┼┐ ├┴─   │┼──┤
│      └─┐    └─┐  │┼─┐      ┌┘   │ │┼─┤   ┌─┼┼┼┼│
│        └─┐    └──┴┘ └─┬┬───┘ ┌─┬┴─┴──┴─  │┼┼┼┼┼│
│          └──┐      │  └┘     └─┘         │┼┼┼┼┼│
│             └──┐   ├─┐   │  │    │  │  ┌─┼┼┼┼┼┼│
│                ├───┼┼┼───┼──┼────┼──┼──┼┼┼┼┼┼┼┼│
└────────────────┴───────────────────────────────┘