┌───────────────────┬──┬───────────────────────────┬───┬──┐
│                   │  │                           │   │  │
│      ┌───────┐    │  │      ┌┐                   │   │  │
│      │       │    │  │      ││                   └───┘  │
│      └──────┬┤    │  │  ┌┐  │┼────────────────┐         │
│             ││    └──┘  ││  │┼────────────────┘         │
│             └┘          ││  ││                       ┌─┬┤
│ ┌────┐                  ││  ││                       │ ││
│ │    ├───┐   ┌────┐     ││  ││                       │ ││
│ └────┴───┘   │    │     └┘  ││             ┌───┐     │ ││
│              │    │         ││             │   │   ┌─┤ ││
│        ┌─┐   │    ├───┐     ││             │   │   │ │ ││
│        │ │   │    ├───┘     ││             │   │   └─┤ ││
│        │ │   │    │         ││             └───┘     │ ││
│        └─┘   │    ├─────────┼┼──┐    ┌───┐           │ ││
├────┐         │    ├─────────────┘    │   │           │ ││
│    │   ┌─────┤    │                  │   │           │ ││
│    │   └─────┤    │                  │   │     ┌┐    │ ││
│    │         │    │    ┌─────────────┤   │     ││    │ ││
│    │  ┌─┐    │    │    └─────────────┤   │     └┘    │ ││
│    │  │ │    │    │                  │   │           └─┴┤
├────┘  │ │    │    │                  │   ├──────────┐   │
│       │ │    │    ├──────────────┐   └───┴──────────┘   │
│  ┌┐   │ │    │    ├────────┼──┼──┘                      │
│  ││   │ │    │    │        │  │      ┌─────────┐        │
│  ││   │ │    │    │        │  │      └──────┼─┼┘        │
│  ││   └─┘    │    ├─────┐  └──┘             │ │         │
│  ││          │    ├─────┘                   └─┘         │
│  ││          │    │                                  X  │
│  ││          │    │        ┌──────────────────────┐     │
└──┴┴──────────┴────┴────────┴──────────────────────┴─────┘