┌────────────┬──┬──┐
│            │  └──┤
├──────┬──         │
│      │    ───────┤
├┬─  │    │        │
││   │ │  └────┬───┤
├  ┌─┤ │       └───┤
│ ┌┤ │ └───  │     │
│X││         ├─────┤
└─┴┴─────────┴─────┘